10
G.G.-.-.P.-.-.-.-.-
G.G.-.-.P.-.-.-.-.-
-.-.W.-.-.-.-.-.-.-
-.P.-.H_P.-.-.-.-.-.-
P.-.-.-.-.-.-.-.-.-
-.-.-.-.-.-.-.-.-.-
-.-.-.P_G.-.-.P.-.-.-
-.-.-.-.-.-.-.G.-.-
-.-.-.-.-.-.-.-.P.-
A.-.-.-.-.-.-.-.-.-