10
G.G.-.-.P.-.-.-.-.-
G.G.-.-.P.-.-.-.G.-
-.-.W.-.-.-.-.-.-.-
-.P.-.-.-.-.-.-.-.-
P.-.-.-.-.-.H_P.-.-.-
-.-.-.-.-.-.-.-.-.-
-.-.-.P_G.-.-.P.-.-.-
-.-.-.-.-.-.-.G.-.-
-.-.-.-.-.-.-.-.P.-
A.-.-.-.-.-.-.-.-.-