10
G.G.-.-.P.-.-.-.-.-
G.G.-.-.-.-.-.-.G.-
-.-.W.-.-.P.-.-.-.-
-.-.-.-.-.-.-.-.-.-
P.-.-.-.-.-.H_P.-.-.-
-.-.-.-.-.-.-.-.-.-
-.-.-.P_G.-.-.-.-.-.-
-.-.-.-.-.-.-.G.-.-
-.-.-.-.-.-.-.-.P.-
A.-.-.-.-.-.-.-.-.-