10
-.G.-.-.-.-.-.-.-.-
W.-.G.-.-.-.-.-.-.-
-.G.-.-.-.-.W.P.-.-
-.-.-.P_G.-.-.-.-.-.-
G.-.-.-.-.P_G.-.-.-.-
-.-.P.-.-.-.-.-.-.-
G.-.-.G.-.-.-.-.-.W
-.-.-.-.G.-.-.G.-.-
-.P.G.-.G.H_P.G.-.-.-
A.-.-.-.-.G.-.-.-.P