10
-.G.P_G.-.-.-.-.-.H_P.-
-.-.-.-.P.-.-.P.-.W
G.-.-.-.-.-.-.-.-.-
-.W.P.-.-.G.-.G.-.G
-.-.P_G.-.-.-.G.-.-.-
-.G.-.-.-.-.W.-.-.-
-.-.-.P.-.-.-.-.-.-
P.-.-.-.-.-.-.W.-.-
-.-.-.P.-.W.-.-.-.-
A.-.-.-.-.-.-.H_P.-.-